# Oggetti (A-Z)

Airhorn=Trombetta ad aria
Apparatice=Reattore
Apparatus=Reattore
Bee hive=Alveare
Big bolt=Grossa vite
Bottles=Bottiglie
Brass bell=Campana
Brush=Pennello
Candy=Leccalecca
Cash register=Registratore di cassa
Chemical jug=Bombola
Clown horn=Trombetta
Coffee mug=Tazza da caffè
Comedy=Commedia
Cookie mold pan=Teglia per biscotti
Double-barrel=Canne mozze
Dust pan=Paletta
Egg beater=Frusta
Fancy lamp=Lampada stilosa
Flask=Ampolla
Gift box=Regalo
Gift=Regalo
Gold Bar=Lingotto d'oro
Golden cup=Calice dorato
Hair brush=Spazzola per capelli
Hairdryer=Asciugacapelli
Homemade flashbang=Granata stordente accroccata
Jar of pickles=Barattolo di cetriolini
Key=Chiave
Large axle=Grosso assiale
Laser pointer=Puntatore laser
Magic 7 ball=Palla delle risposte
Magnifying glass=Lente d'ingrandimento
Metal sheet=Lamiera
Old phone=Vecchio telefono
Painting=Dipinto
Perfume bottle=Flacone di profumo
Pill bottle=Pillole
Plastic fish=Pesce giocattolo
Red soda=Cola
Remote=Telecomando
Ring=Fede nuziale
Robot Toy=Robottino
Rubber ducky=Paperella
Shotgun shell=Cartucce
Steering wheel=Volante
Sticky note=Promemoria
Stop sign=Cartello STOP
Tattered metal sheet=Lamiera danneggiata
Teeth=Dentiera
Toothpaste=Dentifricio
Toy cube=Cubo di Rubik
Tragedy=Tragedia
V-type engine=Motore a V
Wedding ring=Fede nuziale
Whoopie cushion=Cuscino scoreggione
Yield sign="Precedenza"

# Oggetti + Collected (A-Z)

Airhorn collected!=Trombetta ad aria raccolta!
Apparatus collected!=Reattore raccolto!
Bee hive collected!=Alveare raccolto!
Big bolt collected!=Grossa vite raccolta!
Bottles collected!=Bottiglie raccolte!
Brass bell collected!=Campana raccolta!
Brush collected!=Pennello raccolto!
Candy collected!=Leccalecca raccolto!
Cash register collected!=Registratore di cassa raccolto!
Chemical jug collected!=Bombola raccolta!
Clown horn collected!=Trombetta raccolta!
Coffee mug collected!=Tazza da caffè raccolta!
Comedy=Commedia raccolta!
Cookie mold pan collected!=Teglia per biscotti raccolta!
Double-barrel=Fucile raccolto!
Dust pan collected!=Paletta raccolta!
Egg beater collected!=Frusta raccolto!
Fancy lamp collected!=Lampada stilosa raccolta!
Flask collected=Ampolla raccolto!
Gift collected=Regalo raccolto
Gold bar collected!=Lingotto d'oro raccolto!
Golden cup collected!=Calice dorato raccolto
Hair brush collected!=Spazzola per capelli raccolta!
Hairdryer=Asciugacapelli raccolto!
Hive collected!=Alveare raccolto!
Homemade flashbang collected!=Granata accroccata raccolta!
Item collected!=Oggetto raccolto!
Jar of pickles collected!=Barattolo di cetriolini raccolto!
Key collected!=Chiave raccolta!
Large axle collected!=Grosso assiale raccolto!
Laser pointer collected!=Puntatore laser raccolto
Magic 7 ball collected!=Palla delle risposte raccolta!
Magnifying glass collected!=Lente d'ingrandimento raccolta!
Metal sheet collected!=Lamiera raccolta!
Mug collected!=Tazza raccolta!
Old phone collected!=Vecchio telefono raccolto!
Painting collected!=Dipinto raccolto!
Perfume bottle collected!=Flacone di profumo raccolto!
Pill bottle collected!=Pillole raccolte!
Plastic fish collected!=Pesce giocattolo raccolto!
Red soda collected!=Cola raccolta!
Remote collected!=Telecomando raccolto!
Ring collected!=Fede nuziale raccolta!
Rubber ducky collected!=Paperella raccolta!
Shotgun collected!=Fucile raccolto!
Steering wheel collected!=Volante raccolto!
Stop sign collected!=Cartello STOP raccolto!
Tattered metal sheet collected!=Lamiera danneggiata raccolta!
Tea Kettle=Bollitore
Tea kettle collected!=Bollitore raccolto!
Teeth collected!=Lascia Dentiera!
Toothpaste collected!=Dentifricio raccolto!
Toy cube collected!=Cubo di Rubik raccolto!
Toy robot collected!=Robottino raccolto!
Tragedy=Tragedia raccolta!
V-type engine collected!=Motore a V raccolto!
Wedding ring collected!=Fede nuziale raccolta!
Whoopie cushion collected!=Cuscino scoreggione raccolto!
Yield sign collected!=C. "Precedenza" raccolto!

# Oggetti + Drop (A-Z)

Drop Airhorn : [G]=Lascia Trombetta ad aria : [G]
Drop Ammo : [G]=Lascia Cartuccia : [G]
Drop Apparatus : [G]=Lascia Reattore: [G]
Drop Bee hive : [G]=Lascia Alveare : [G]
Drop Bell : [G]=Lascia Campana : [G]
Drop Big bolt : [G]=Lascia Grossa vite : [G]
Drop Bottles : [G]=Lascia Bottiglie : [G]
Drop Brass bell : [G]=Lascia Campana : [G]
Drop Brush : [G]=Lascia Pennello : [G]
Drop Candy : [G]=Lascia Leccalecca : [G]
Drop Cash register : [G]=Lascia Registratore di cassa : [G]
Drop Chemical jug : [G]=Lascia Bombola : [G]
Drop Clown horn : [G]=Lascia Trombetta : [G]
Drop Coffee mug : [G]=Lascia Tazza da caffè : [G] 
Drop Comedy : [G]=Lascia Commedia : [G]
Drop Cookie mold pan : [G]=Lascia Teglia per biscotti : [G]
Drop Dust pan : [G]=Lascia Paletta : [G]
Drop Egg beater : [G]=Lascia Frusta : [G]
Drop Fancy lamp : [G]=Lascia Lampada stilosa : [G]
Drop Flask : [G]=Lascia Ampolla : [G]
Drop Gift : [G]=Lascia Regalo : [G]
Drop Gold bar : [G]=Lascia Lingotto d'oro : [G]
Drop Golden cup : [G]=Lascia Calice dorato : [G]
Drop Hair brush : [G]=Lascia Spazzola per capelli : [G]
Drop Hairdryer : [G]=Lascia Asciugacapelli : [G]
Drop Homemade flashbang : [G]=Lascia Granata accroccata : [G]
Drop Jar of pickles : [G]=Lascia Barattolo di cetriolini : [G]
Drop Key : [G]=Lascia Chiave : [G]
Drop Large axle : [G]=Lascia Grosso assiale : [G]
Drop Laser pointer : [G]=Lascia Puntatore laser : [G]
Drop Magic 7 ball : [G]=Lascia Palla delle risposte : [G]
Drop Magnifying glass : [G]=Lascia Lente d'ingrandimento : [G]
Drop Metal sheet : [G]= Lascia Lamiera : [G]
Drop Mug : [G]=Lascia Tazza: [G]
Drop Old phone : [G]=Lascia Vecchio telefono : [G]
Drop Painting : [G]=Lascia Dipinto : [G]
Drop Perfume bottle : [G]=Lascia profumo : [G]
Drop Pill bottle : [G]=Lascia Pillole : [G]
Drop Plastic fish : [G]=Lascia Pesce giocattolo : [G]
Drop Red soda : [G]=Lascia Cola : [G]
Drop Remote : [G]=Lascia Telecomando : [G]
Drop Ring : [G]=Lascia Fede nuziale : [G]
Drop Rubber ducky : [G]=Lascia Paperella : [G]
Drop Shotgun : [G]=Lascia Fucile : [G]
Drop Steering wheel : [G]=Lascia Volante : [G]
Drop Sticky note : [G]=Lascia Promemoria : [G]
Drop Stop sign : [G]=Lascia Cartello STOP : [G]
Drop Tattered metal sheet : [G]= Lascia Lamiera danneggiata : [G]
Drop Tea kettle : [G]=Lascia Bollitore: [G]
Drop Teeth : [G]=Dentiera raccolta: [G]
Drop Toothpaste : [G]=Lascia Dentifricio : [G]
Drop Toy cube : [G]=Lascia Cubo di Rubik : [G]
Drop Toy robot : [G]=Lascia Robottino : [G]
Drop Tragedy : [G]=Lascia Tragedia : [G]
Drop V-type engine : [G]=Lascia Motore a V : [G]
Drop Walkie-talkie : [G]=Lascia Walkie-talkie : [G]
Drop Wedding ring : [G]=Lascia Fede nuziale : [G]
Drop Whoopie cushion : [G]=Lascia Cuscino scoreggione : [G]
Drop Yield sign : [G]=Lascia Cartello "Precedenza" : [G]

# Shotgun

Fire : [LMB]=Spara : [TSM]
Reload : [E]=Ricarica : [E]
Turn safety on: [Q]=Metti la sicura: [Q]
Turn safety off: [Q]=Togli la sicura: [Q]